############################
#............##............#
#.####.#####.##.#####.####.#
#*####.#####.##.#####.####*#
#.####.#####.##.#####.####.#
#..........................#
#.####.##.########.##.####.#
#.####.##.########.##.####.#
#......##....##....##......#
######.##### ## #####.######
######.##### ## #####.######
######.##          ##.######
######.## ######## ##.######
######.## #      # ##.######
      .   #      #   .      
######.## #      # ##.######
######.## ######## ##.######
